#.........
#...###...
#.........
#...##....
..........
.##....#..
.......#..
...#...#..
...#......
...#..##..